#####################################
##############....###################
###>>>>>>###....................#####
###>>>>>>###.....................####
###>>>>>>###.....................####
###>>>>>>###......................###
###......###......############....###
###......###....##############....###
###......###....##########........###
###......##.....##................###
####.....##....###................###
####.....##....###................###
####.....##....###.....##############
####.....##....###.....##############
####.....###....##.....##############
####.....###....##.....##############
###......###....##.....##############
###......###....##..............#####
###......###....###...............###
###......##.....###...............###
###.......#.....####..............###
###.......#.....###############...###
###.......##....###############...###
####......##....###############...###
####......##....#############.....###
####......##....###****...........###
####......##....###****...........###
#####...........###****...........###
#####...........###****...........###
#####...........###****...........###
#######........####****...........###
#####################################
#####################################
#####################################
#####################################
